
























##################################################
#                                                #
#                                                #
#                                                #
#                                                #
#                                                #
#                                          O     #
#                                         ###    #
#                                          #     #
#                                          #     #
#      ################    #########        ######
#     ##                                         #
# B  ##                                          #
######   #                                       #
#                                                #
#                                                #
#        #                                       #
#                                               ##
#   #                                    #  #   ##
##             #                   #  #   ##  ## #
# #                               # #      #  #  #
## #### ###   #  ### #### ### ###### ####### #####
 ### ##### #####  # # ### ####### ## #### ### ### 
  # ### # ### # # ### ## #### ##### ###### ###### 
# #### ## #### ### # #### ######## #### ### ## ## 