










                        
                  
   
                                              OOOO
###############################################  #
>                               @                #
                                                 #
#      #########  #################  #########  ##
#              ####               ####       #  ##
#                                   #            #
#   ##                              #            #
#                                   #   @ #######@
#                                   #            #
###                                 #            #
#                                   #            #
#@               ###                #            #
# ########                          #            #
#                            #      #            #
#                                   #  #######   #
#   @                               #        #   #
#                                   #        #@  #
#                        ###########@######  #   #
#  @                    #           #        #   #
#                      #            #        #   #
#                                   #  #######   #
#                                   #        #   #
#                  @          @@    #        #   #
#        ###########       ######   #######  #   #
#       ##@@     @@#       #                 #   #
#        #@       @#       #                 #   #
#        #         #       #   ###############   #
#        #         #       #   #@                #
##       #         #       #   #                 #
###                #        #  #                 #
# ##               #        # B#                 #
#  ##              @        ####                 #
>   ##       @                        @          #
     ##      @                        @         @@
################################################@@