










                        
                  
   
   
##################################################
#                                                #
#                     B                          #
#               #############                    #
>                                                #
                                                 #
#                                                #
#                    @                  @       < 
#                                                 
#  @  @                                          #
#                                @               #
#        @                                       #
#                                    @           #
#                                                #
#                     @                          #
>                                                #
        @                                        #
#                                               < 
#                              @                  
#                                                #
#                                                #
#     @                                          #
#                                  @             #
#                  @                             #
#                                               < 
#                                                 
#                                                #
>                                      @         #
         @                                       #
#                                 @              #
#                                                #
#                 @                              #
#                                                #
#                                                #
OOOOOOOOOOOOOOOOOOOOOOOOOOOOOOOOOOOOOOOOOOOOOOOOOO