
























##################################################
#                                              < #
#                                                #
#                                              ###
#                                                #
#B                                               #
#############################################    #
#>                                               #
#                                                #
###                                              #
#            #             #              #      #
#           ###           ###            ###     #
#    #############################################
#                 #                            < #
#                 #                              #
#           #     #           #                ###
#           #     #          # #                 #
###        ##               #   #                #
#>        ###              #     #               #
#        ####             #       #              #
##########################    O    ###########   #
# @                                              #
#@ @ @                        #                  #
# @ @ @ @                     #                  #
##################################################  