
























##################################################
#                    @  @ @ @ @@@ @  @#          #
#                    @@ @  @  @ @ @@ @#          #
#O                   @ @@  @  @@@ @ @@#          #
##                   @  @  @  @ @ @  @ #         #
#@#                                    #         #
#@@#                                    ## B     #
#@@@#                                ###  ###    #
#@@@@#                              #            #
#@@@@@#@@@                         #             #
#@@@@@@################      #######    ##########
#@@@@@#                     #      #             #
#@@@@#                      #      #             #
#####                   ####       #@            #
#              #       #            #   #        #
#    @         #                     ###         #
#              #                                 #
#      ##       ##                               #
#                 #                              #
##                #                 #            #
# #       @       #      @@        #             #
## #    ###########################             ##
 ###                                 ####     ### 
  # #                               ##  ##@@###   
# ###################################    #####    