                         B




















#################################################



##      ####  ###### #####  ## #     ##  ######
##     ###### ###### ###### ## ##    ## ########
##     ##  ## ##  ## ##  ## ## ###   ## ##    ##
##     ##  ## ##  ## ##  ## ## ####  ## ##
##     ##  ## ###### ##  ## ## ##### ## ##
##     ##  ## ###### ##  ## ## ## ##### ##   ###
##     ##  ## ##  ## ##  ## ## ##  #### ##   ###
##     ##  ## ##  ## ##  ## ## ##   ### ##    ##
###### ###### ##  ## ###### ## ##    ## ########
######  ####  ##  ## #####  ## ##    ##  ######



##################################################