





























##################################################
#                                                #
#                                                #
#                                                #
#                                                #
#                                                #
#                                                #
# O                                              #
#########                                        #
#        #####                                   #
#                                                #
#                                                #
#                 ##                             #
##               ###                             #
###            ######                            #
####        ##########                           #
#####    ###############                         #
###### #####################                     #
#####################################          B #
##################################################