






                        

                  

   

   

@@@@@@@@@@@@@@@@@@@@@@@@@@@@@@@@@@@@@@@@@@@@@@@@@@
@                                                @
@                   B                            @
@   @                                     @      @
@                                                @
@                               @                @
@                                                @
@   @                                      @     @
@                                                @
@                                                @
@        @        @ @@ @                         @
@                                     @          @
@                                                @
@                                                @
@    @                                          @@
@@                                         @   @ @
@@ @                                        @@ @@ 
@ @@@ @@                        @@ @ @ @@ @@ @@ @@
 @@ @ @@ @@ @ @         @@@ @ @@ @ @  @  @  @ @ @@
 @@@                              @         @@    
@   @                                     @   @@ @
@                                               @@
@                                                @
@                                       @        @
@            @                                   @
@                                                @
@  @             @                               @
@                                              < @
@                                  @             @
@                                                @
@>                                               @
@                     @       @      @           @
@     @                                          @
@                                                @
OOOOOOOOOOOOOOOOOOOOOOOOOOOOOOOOOOOOOOOOOOOOOOOOOO