










                        
                  
   
   
@@@@@@@@@@@@@@@@@@@@@@@@@@@@@@@@@@@@@@@@@@@@@@@@@@
@                                                @
@                                                @
@                   B                            @
@  @                                      @      @
@                              @                 @
@                                                @
@                                                @
@                                                @
@      ######  ##  ##  ######                    @
@      ######  ##  ##  ######                    @
@        ##@   ##  ##  ##             @          @
@        ##    ##  ##  ##                        @
@        ##    ######  ####@                     @
@        ##    ######  ####                      @
@        ##    ##@ ##  ##               @        @
@        ##    ##  ##  ##@                       @
@        ##    ##  ##  ######                    @
@       @##    ##  ##  ######                    @
@                                         @      @
@                                                @
@                 ######  #     ##  #####        @
@                 ######  ##    ##  ######       @
@                 ##      ####  ##  ##@@##       @
@  @              ##      #####@##  ##@@##       @
@                 ####    ##@#####  ##@@##       @
@      @          ####    ##  ####  ##@@##       @
@                 ##      ##   ###  ##@@##       @
@                @##      ##    ##  ##@@##       @
@                 ######  ##    ##  ######       @
@                 ######  ##    ##  #####        @
@   @                                            @
@                                        @       @
@                                                @
OOOOOOOOOOOOOOOOOOOOOOOOOOOOOOOOOOOOOOOOOOOOOOOOOO